Titanfall2	Titanfall2	타이탄폴2
battlefield1	Battlefiled1	배틀필드1
fairy_bloom_freesia	Fairy Bloom Freesia	꽃 피우는 요정 프리지아
eryis_action	Eryi's Action	에리의 액션
exceed2	eXceed 2nd - Vampire REX	익시드2
exceed3	eXceed 3rd - Jade Penetrate Black Package	익시드3
ether	ETHER VAPOR Remaster	에테르 베이퍼
bad_hotel	BAD HOTEL	배드호텔
the_cat_lady	The Cat Lady	더 캣 레이디
daikatana	Daikatana	다이카타나
red_faction_armageddon	Red faction : Armageddon	레드팩션 : 아마겟돈
downfall	Downfall	다운폴
astebreed	Astebreed	아스터브리드
legend_hero_kuro_no_kiseki	英雄伝説 黎 の軌跡	영웅전설 여의 궤적
fate_grand_order	Fate/Grand Order	페이트/그랜드 오더
adventure_of_nayu	The adventure of NAYU	나유의 모험
the_medium	The Medium	더 미디엄
haven	Haven	헤이븐
steins_gate	STEINS;GATE	슈타인즈 게이트
女騎士を目指して	女騎士を目指して	여자기사를 목표로
ritual_summon	ニセモノ聖女の邪教討伐 / Ritual Summon	가짜 성녀의 사교 토벌	
wing_commander5	Wing Commander: Prophecy	윙커맨더 5 : 예언
subverse	Subverse	섭버스
lagoon2	Lagoon Lounge2	라군 라운지2
guildwars2	Guild Wars2	길드워2
psychonauts2	Psychonauts2	사이코너츠2
coq	Caves of Qud	케이브 오브 쿼드
あんさんぶるスターズ	あんさんぶるスターズ!	앙상블 스타즈!